###################
#                 #
#   ######        #
#   #    #        #
#   #    #        #
#   #         #####
#   #         #   #
#             #   #
#   ######    #   #
#   #    #    #   #
#   #    #        #
#   #    #        #
#                 #
#                 #
###################
