#################
#               #
#               #
#               #
#               #
#   ###    ######
#               #
#               #
#   ###    ######
#               #
#               #
#               #
#               #
#               #
#               #
#################
