# mazes/maze_narrow.txt (19x15 grid with narrow passages)
###################
#        #        #
# ###### # ###### #
# #    #   #    # #
# # ## ##### ## # #
# # #         # # #
# # # ####### # # #
#   #         #   #
# # # ####### # # #
# # #         # # #
# # ## ##### ## # #
# #    #   #    # #
# ###### # ###### #
#        #        #
###################
