#################
#               #
#               #
#   #           #
#   #           #
#   #           #
#   #      #    #
#   #      #    #
#   #      #    #
#   #      #    #
#   #      #    #
#   #      #    #
#          #    #
#          #    #
#               #
#################
