###################
#                 #
#   #       #    #
#   #       #    #
#   #            #
#         ###    #
#                #
#    #           #
#    #     #     #
#    #     #     #
#          #     #
#    ###         #
#                #
#                 #
###################
