###################
#                 #
#                 #
#    # # # # #    #
#            #    #
#    #   #   #    #
#    #   #   #    #
#    #   #   #    #
#    #   #   #    #
#    #   #   #    #
#    #       #    #
#    # # # # #    #
#                 #
#                 #
###################
