#################
#               #
#               #
#    # # # #    #
#          #    #
#    #     #    #
#    #     #    #
#    #     #    #
#    #     #    #
#    #     #    #
#    #     #    #
#    # # # #    #
#               #
#               #
#               #
#################
