# mazes/maze_rooms.txt (19x15 grid with multiple rooms)
###################
#    #     #     #
#    #     #     #
#    #     #     #
##### ##### #####
#    #     #     #
#    #     #     #
#    #     #     #
##### ##### #####
#    #     #     #
#    #     #     #
#    #     #     #
#    #     #     #
#    #     #     #
###################
