###################
#                 #
#  ###  #####  ###
#    #  #   #    #
#    #  #   #    #
#    #      #    #
#    ########    #
#                #
#    ########    #
#    #      #    #
#    #  #   #    #
#    #  #   #    #
#  ###  #####  ###
#                 #
###################
