# mazes/maze_spiral.txt (19x15 grid with spiral pattern)
###################
#                 #
# ############### #
# #             # #
# # ########### # #
# # #         # # #
# # # ##### # # # #
# # # #   # # # # #
# # # # # # # # # #
# # # #     # # # #
# # #         # # #
# # ########### # #
# #             # #
#               # #
###################
