#################
#               #
#   ######      #
#               #
#   #           #
#   #       #####
#   #           #
#               #
#   ######      #
#               #
#               #
#       ###     #
#               #
#               #
#               #
#################
