####################
#                  #
#                  #
#    # # # # #     #
#            #     #
#    #   #   #     #
#    #   #   #     #
#    #   #   #     #
#    #   #   #     #
#    #   #   #     #
#    #       #     #
#    # # # # #     #
#                  #
#                  #
####################
