###################
#                 #
#                 #
#   #             #
#   #             #
#   #         #####
#   #             #
#                 #
#                 #
#   #             #
#   #             #
#                 #
#                 #
#                 #
###################
