# mazes/maze1.txt (Example: 20x15 with internal walls)
####################
#                  #
#   ######         #
#   #    #         #
#   #    #         #
#   #          #####
#   #          #   #
#              #   #
#   ######     #   #
#   #    #     #   #
#   #    #         #
#   #    #         #
#                  #
#         #####    #
####################
