###################
#                 #
#                 #
#   #             #
#   #             #
#   #             #
#   #        #    #
#   #        #    #
#   #        #    #
#   #        #    #
#   #        #    #
#   #        #    #
#            #    #
#            #    #
###################
