#################
#               #
#   ######      #
#   #           #
#   #           #
#   #       #####
#   #       #   #
#               #
#   ######      #
#   #    #      #
#   #    #      #
#   #    #      #
#               #
#               #
#               #
#################
